$pitchshiftrange 0

crash/crash1	sounds/DUCK.ogg
crash/crash2	sounds/BORK98.ogg
crash/crash3	sounds/BORKXP.ogg
crash/crash4	sounds/GNOME.ogg
crash/crash5	sounds/FRANCETIM.ogg
crash/crash6	sounds/ONO.ogg
$random crash/crash { crash/crash1 crash/crash2 crash/crash3 crash/crash4 crash/crash5 crash/crash6 }
crash/glass	sounds/GLASSCRK.ogg
crash/curb	sounds/CURB.ogg
brutal/ezmodo	sounds/EASYMODO.ogg
bestsound	sounds/CORK.ogg
haha/dab	sounds/DAB.ogg
bruh		sounds/BRUH.ogg
squeak		sounds/SQUEAK.ogg
recordscratch	sounds/RECSCRAP.ogg
compat/warn	sounds/UTWARN.ogg

saya/giggle1	sounds/saya/saya_giggle1.ogg
saya/giggle2	sounds/saya/saya_giggle2.ogg
saya/giggle3	sounds/saya/saya_giggle3.ogg
saya/giggle4	sounds/saya/saya_giggle4.ogg
saya/giggle5	sounds/saya/saya_giggle5.ogg
saya/giggle6	sounds/saya/saya_giggle6.ogg
saya/giggle7	sounds/saya/saya_giggle7.ogg
saya/giggle8	sounds/saya/saya_giggle8.ogg
saya/giggle9	sounds/saya/saya_giggle9.ogg
saya/giggle10	sounds/saya/saya_giggle10.ogg
saya/giggle11	sounds/saya/saya_giggle11.ogg
saya/giggle12	sounds/saya/saya_giggle12.ogg
saya/giggle13	sounds/saya/saya_giggle13.ogg
saya/giggle14	sounds/saya/saya_giggle14.ogg
$random saya/giggle { saya/giggle1 saya/giggle2 saya/giggle3 saya/giggle4 saya/giggle5 saya/giggle6 saya/giggle7 saya/giggle8 saya/giggle9 saya/giggle10 saya/giggle11 saya/giggle12 saya/giggle13 saya/giggle14 }
saya/pervert	sounds/saya/saya_pervert.ogg

kirin/giggle1	sounds/kirin/kirin_giggle1.ogg
kirin/giggle2	sounds/kirin/kirin_giggle2.ogg
kirin/giggle3	sounds/kirin/kirin_giggle3.ogg
kirin/giggle4	sounds/kirin/kirin_giggle4.ogg
kirin/giggle5	sounds/kirin/kirin_giggle5.ogg
kirin/giggle6	sounds/kirin/kirin_giggle6.ogg
kirin/giggle7	sounds/kirin/kirin_giggle7.ogg
kirin/giggle8	sounds/kirin/kirin_giggle8.ogg
kirin/giggle9	sounds/kirin/kirin_giggle9.ogg
kirin/giggle10	sounds/kirin/kirin_giggle10.ogg
kirin/giggle11	sounds/kirin/kirin_giggle11.ogg
$random kirin/giggle { kirin/giggle1 kirin/giggle2 kirin/giggle3 kirin/giggle4 kirin/giggle5 kirin/giggle6 kirin/giggle7 kirin/giggle8 kirin/giggle9 kirin/giggle10 kirin/giggle11 }

voice/default/death1      	sounds/voice/default/demodeath1.ogg
voice/default/death2      	sounds/voice/default/demodeath2.ogg
voice/default/death3      	sounds/voice/default/demodeath3.ogg
voice/default/death4      	sounds/voice/default/demodeath4.ogg
voice/default/death5      	sounds/voice/default/demodeath5.ogg
voice/default/fightstart1 	sounds/voice/default/demofightstart1.ogg
voice/default/fightstart2 	sounds/voice/default/demofightstart2.ogg
voice/default/fightstart3 	sounds/voice/default/demofightstart3.ogg
voice/default/fightstart4 	sounds/voice/default/demofightstart4.ogg
voice/default/fightstart5 	sounds/voice/default/demofightstart5.ogg
voice/default/fightstart6 	sounds/voice/default/demofightstart6.ogg
voice/default/fightstart7 	sounds/voice/default/demofightstart7.ogg
voice/default/fightstart8 	sounds/voice/default/demofightstart8.ogg
voice/default/fightstart9 	sounds/voice/default/demofightstart9.ogg
voice/default/fightstart10	sounds/voice/default/demofightstart10.ogg
voice/default/fightstart11	sounds/voice/default/demofightstart11.ogg
voice/default/fightstart12	sounds/voice/default/demofightstart12.ogg
voice/default/fightstart13	sounds/voice/default/demofightstart13.ogg
voice/default/fightstart14	sounds/voice/default/demofightstart14.ogg
voice/default/fightstart15	sounds/voice/default/demofightstart15.ogg
voice/default/fightstart16	sounds/voice/default/demofightstart16.ogg
voice/default/fightstart17	sounds/voice/default/demofightstart17.ogg
voice/default/fightstart18	sounds/voice/default/demofightstart18.ogg
voice/default/fightstart19	sounds/voice/default/demofightstart19.ogg
voice/default/fightstart20	sounds/voice/default/demofightstart20.ogg
voice/default/fightstart21	sounds/voice/default/demofightstart21.ogg
voice/default/findsecret1 	sounds/voice/default/demofindsecret1.ogg
voice/default/findsecret2 	sounds/voice/default/demofindsecret2.ogg
voice/default/findsecret3 	sounds/voice/default/demofindsecret3.ogg
voice/default/findsecret4 	sounds/voice/default/demofindsecret4.ogg
voice/default/findsecret5 	sounds/voice/default/demofindsecret5.ogg
voice/default/findsecret6 	sounds/voice/default/demofindsecret6.ogg
voice/default/findsecret7 	sounds/voice/default/demofindsecret7.ogg
voice/default/findsecret8 	sounds/voice/default/demofindsecret8.ogg
voice/default/findsecret9 	sounds/voice/default/demofindsecret9.ogg
voice/default/findsecret10	sounds/voice/default/demofindsecret10.ogg
voice/default/findsecret11	sounds/voice/default/demofindsecret11.ogg
voice/default/findsecret12	sounds/voice/default/demofindsecret12.ogg
voice/default/findsecret13	sounds/voice/default/demofindsecret13.ogg
voice/default/getweapon1  	sounds/voice/default/demogetweapon1.ogg
voice/default/getweapon2  	sounds/voice/default/demogetweapon2.ogg
voice/default/getweapon3  	sounds/voice/default/demogetweapon3.ogg
voice/default/getweapon4  	sounds/voice/default/demogetweapon4.ogg
voice/default/getweapon5  	sounds/voice/default/demogetweapon5.ogg
voice/default/getweapon6  	sounds/voice/default/demogetweapon6.ogg
voice/default/getweapon7  	sounds/voice/default/demogetweapon7.ogg
voice/default/getweapon8  	sounds/voice/default/demogetweapon8.ogg
voice/default/getweapon9  	sounds/voice/default/demogetweapon9.ogg
voice/default/getweapon10 	sounds/voice/default/demogetweapon10.ogg
voice/default/getweapon11 	sounds/voice/default/demogetweapon11.ogg
voice/default/getweapon12 	sounds/voice/default/demogetweapon12.ogg
voice/default/getweapon13 	sounds/voice/default/demogetweapon13.ogg
voice/default/grunt1      	sounds/voice/default/demogrunt1.ogg
voice/default/grunt2      	sounds/voice/default/demogrunt2.ogg
voice/default/grunt3      	sounds/voice/default/demogrunt3.ogg
voice/default/grunt4      	sounds/voice/default/demogrunt4.ogg
voice/default/grunt5      	sounds/voice/default/demogrunt5.ogg
voice/default/grunt6      	sounds/voice/default/demogrunt6.ogg
voice/default/hipain1     	sounds/voice/default/demohipain1.ogg
voice/default/hipain2     	sounds/voice/default/demohipain2.ogg
voice/default/hipain3     	sounds/voice/default/demohipain3.ogg
voice/default/hipain4     	sounds/voice/default/demohipain4.ogg
voice/default/hipain5     	sounds/voice/default/demohipain5.ogg
voice/default/locked1     	sounds/voice/default/demolocked1.ogg
voice/default/locked2     	sounds/voice/default/demolocked2.ogg
voice/default/locked3     	sounds/voice/default/demolocked3.ogg
voice/default/locked4     	sounds/voice/default/demolocked4.ogg
voice/default/jammed1     	sounds/voice/default/demojammed1.ogg
voice/default/jammed2     	sounds/voice/default/demojammed2.ogg
voice/default/jammed3     	sounds/voice/default/demojammed3.ogg
voice/default/jammed4     	sounds/voice/default/demojammed4.ogg
voice/default/lopain1     	sounds/voice/default/demolopain1.ogg
voice/default/lopain2     	sounds/voice/default/demolopain2.ogg
voice/default/lopain3     	sounds/voice/default/demolopain3.ogg
voice/default/lopain4     	sounds/voice/default/demolopain4.ogg
voice/default/lopain5     	sounds/voice/default/demolopain5.ogg
voice/default/mapstart1   	sounds/voice/default/demomapstart1.ogg
voice/default/mapstart2   	sounds/voice/default/demomapstart2.ogg
voice/default/mapstart3   	sounds/voice/default/demomapstart3.ogg
voice/default/mapstart4   	sounds/voice/default/demomapstart4.ogg
voice/default/mapstart5   	sounds/voice/default/demomapstart5.ogg
voice/default/mapstart6   	sounds/voice/default/demomapstart6.ogg
voice/default/mapstart7   	sounds/voice/default/demomapstart7.ogg
voice/default/mapstart8   	sounds/voice/default/demomapstart8.ogg
voice/default/mapstart9   	sounds/voice/default/demomapstart9.ogg
voice/default/mapstart10  	sounds/voice/default/demomapstart10.ogg
voice/default/mapstart11  	sounds/voice/default/demomapstart11.ogg
voice/default/mapstart12  	sounds/voice/default/demomapstart12.ogg
voice/default/mapstart13  	sounds/voice/default/demomapstart13.ogg
voice/default/mapstart14  	sounds/voice/default/demomapstart14.ogg
voice/default/pain1       	sounds/voice/default/demopain1.ogg
voice/default/pain2       	sounds/voice/default/demopain2.ogg
voice/default/pain3       	sounds/voice/default/demopain3.ogg
voice/default/pain4       	sounds/voice/default/demopain4.ogg
voice/default/pain5       	sounds/voice/default/demopain5.ogg
voice/default/pain6       	sounds/voice/default/demopain6.ogg
voice/default/puzzfail1   	sounds/voice/default/demopuzzfail1.ogg
voice/default/puzzfail2   	sounds/voice/default/demopuzzfail2.ogg
voice/default/puzzfail3   	sounds/voice/default/demopuzzfail3.ogg
voice/default/puzzfail4   	sounds/voice/default/demopuzzfail4.ogg
voice/default/puzzfail5   	sounds/voice/default/demopuzzfail5.ogg
voice/default/puzzfail6   	sounds/voice/default/demopuzzfail6.ogg
voice/default/puzzsucc1   	sounds/voice/default/demopuzzsucc1.ogg
voice/default/puzzsucc2   	sounds/voice/default/demopuzzsucc2.ogg
voice/default/puzzsucc3   	sounds/voice/default/demopuzzsucc3.ogg
voice/default/puzzsucc4   	sounds/voice/default/demopuzzsucc4.ogg
voice/default/puzzsucc5   	sounds/voice/default/demopuzzsucc5.ogg
voice/default/scorekill1  	sounds/voice/default/demoscorekill1.ogg
voice/default/scorekill2  	sounds/voice/default/demoscorekill2.ogg
voice/default/scorekill3  	sounds/voice/default/demoscorekill3.ogg
voice/default/scorekill4  	sounds/voice/default/demoscorekill4.ogg
voice/default/scorekill5  	sounds/voice/default/demoscorekill5.ogg
voice/default/scorekill6  	sounds/voice/default/demoscorekill6.ogg
voice/default/scorekill7  	sounds/voice/default/demoscorekill7.ogg
voice/default/scorekill8  	sounds/voice/default/demoscorekill8.ogg
voice/default/scorekill9  	sounds/voice/default/demoscorekill9.ogg
voice/default/scorekill10 	sounds/voice/default/demoscorekill10.ogg
voice/default/scorekill11 	sounds/voice/default/demoscorekill11.ogg
voice/default/scorekill12 	sounds/voice/default/demoscorekill12.ogg
voice/default/scorekill13 	sounds/voice/default/demoscorekill13.ogg
voice/default/scorekill14 	sounds/voice/default/demoscorekill14.ogg
voice/default/scorekill15 	sounds/voice/default/demoscorekill15.ogg
voice/default/scorekill16 	sounds/voice/default/demoscorekill16.ogg
voice/default/scorekill17 	sounds/voice/default/demoscorekill17.ogg
voice/default/scorekill18 	sounds/voice/default/demoscorekill18.ogg
voice/default/scorekill19 	sounds/voice/default/demoscorekill19.ogg
voice/default/scorekill20 	sounds/voice/default/demoscorekill20.ogg
voice/default/scorekill21 	sounds/voice/default/demoscorekill21.ogg
voice/default/scorekill22 	sounds/voice/default/demoscorekill22.ogg
voice/default/scorekill23 	sounds/voice/default/demoscorekill23.ogg
voice/default/scorekill24 	sounds/voice/default/demoscorekill24.ogg
voice/default/scorekill25 	sounds/voice/default/demoscorekill25.ogg
voice/default/scorekill26 	sounds/voice/default/demoscorekill26.ogg
voice/default/friendkill1	sounds/voice/default/demofriendkill1.ogg
voice/default/friendkill2	sounds/voice/default/demofriendkill2.ogg
voice/default/friendkill3	sounds/voice/default/demofriendkill3.ogg
voice/default/friendkill4	sounds/voice/default/demofriendkill4.ogg
voice/default/gethit1  		sounds/voice/default/demogethit1.ogg
voice/default/gethit2  		sounds/voice/default/demogethit2.ogg
voice/default/gethit3  		sounds/voice/default/demogethit3.ogg
voice/default/gethit4  		sounds/voice/default/demogethit4.ogg
voice/default/gethit5  		sounds/voice/default/demogethit5.ogg
voice/default/gethit6  		sounds/voice/default/demogethit6.ogg
voice/default/gethit7  		sounds/voice/default/demogethit7.ogg
voice/default/gethit8  		sounds/voice/default/demogethit8.ogg
voice/default/gethit9  		sounds/voice/default/demogethit9.ogg
voice/default/gethit10 		sounds/voice/default/demogethit10.ogg
voice/default/gethit11 		sounds/voice/default/demogethit11.ogg
voice/default/gethit12 		sounds/voice/default/demogethit12.ogg
voice/default/gethit13 		sounds/voice/default/demogethit13.ogg
voice/default/gethit14 		sounds/voice/default/demogethit14.ogg
voice/default/gethit15 		sounds/voice/default/demogethit15.ogg
voice/default/gethit16 		sounds/voice/default/demogethit16.ogg
voice/default/gethit17 		sounds/voice/default/demogethit17.ogg
voice/default/gethit18 		sounds/voice/default/demogethit18.ogg
voice/default/gethit19 		sounds/voice/default/demogethit19.ogg
voice/default/friendhit1	sounds/voice/default/demofriendhit1.ogg
voice/default/friendhit2	sounds/voice/default/demofriendhit2.ogg
voice/default/friendhit3	sounds/voice/default/demofriendhit3.ogg
voice/default/friendhit4	sounds/voice/default/demofriendhit4.ogg
voice/default/friendhit5	sounds/voice/default/demofriendhit5.ogg
voice/default/friendhit6	sounds/voice/default/demofriendhit6.ogg
voice/default/friendhit7	sounds/voice/default/demofriendhit7.ogg
voice/default/greet1		sounds/voice/default/demogreet1.ogg
voice/default/greet2		sounds/voice/default/demogreet2.ogg
voice/default/greet3		sounds/voice/default/demogreet3.ogg
voice/default/greet4		sounds/voice/default/demogreet4.ogg
voice/default/greet5		sounds/voice/default/demogreet5.ogg
voice/default/greet6		sounds/voice/default/demogreet6.ogg
voice/default/greet7		sounds/voice/default/demogreet7.ogg
voice/default/hitfriend1	sounds/voice/default/demohitfriend1.ogg
voice/default/hitfriend2	sounds/voice/default/demohitfriend2.ogg
voice/default/hitfriend3	sounds/voice/default/demohitfriend3.ogg
voice/default/ragekit1		sounds/voice/default/demoragekit1.ogg
voice/default/ragekit2		sounds/voice/default/demoragekit2.ogg
voice/default/ragekit3		sounds/voice/default/demoragekit3.ogg
voice/default/ragekit4		sounds/voice/default/demoragekit4.ogg
voice/default/ragekit5		sounds/voice/default/demoragekit5.ogg
voice/default/ragekit6		sounds/voice/default/demoragekit6.ogg
voice/default/koraxgreet1	sounds/voice/default/demokoraxgreet1.ogg
voice/default/koraxgreet2	sounds/voice/default/demokoraxgreet2.ogg
voice/default/koraxgreet3	sounds/voice/default/demokoraxgreet3.ogg
voice/default/koraxgreet4	sounds/voice/default/demokoraxgreet4.ogg
voice/default/koraxgreet5	sounds/voice/default/demokoraxgreet5.ogg
voice/default/koraxgreet6	sounds/voice/default/demokoraxgreet6.ogg
voice/default/koraxgreet7	sounds/voice/default/demokoraxgreet7.ogg
voice/default/koraxgreet8	sounds/voice/default/demokoraxgreet8.ogg
voice/default/koraxgreet9	sounds/voice/default/demokoraxgreet9.ogg
voice/default/koraxgreet10	sounds/voice/default/demokoraxgreet10.ogg
voice/default/koraxgreet11	sounds/voice/default/demokoraxgreet11.ogg
voice/default/koraxgreet12	sounds/voice/default/demokoraxgreet12.ogg
voice/default/koraxgreet13	sounds/voice/default/demokoraxgreet13.ogg
voice/default/koraxblood1	sounds/voice/default/demokoraxblood1.ogg
voice/default/koraxblood2	sounds/voice/default/demokoraxblood2.ogg
voice/default/koraxblood3	sounds/voice/default/demokoraxblood3.ogg
voice/default/koraxblood4	sounds/voice/default/demokoraxblood4.ogg
voice/default/koraxblood5	sounds/voice/default/demokoraxblood5.ogg
voice/default/koraxblood6	sounds/voice/default/demokoraxblood6.ogg
voice/default/koraxblood7	sounds/voice/default/demokoraxblood7.ogg
voice/default/koraxblood8	sounds/voice/default/demokoraxblood8.ogg
voice/default/koraxblood9	sounds/voice/default/demokoraxblood9.ogg
voice/default/koraxblood10	sounds/voice/default/demokoraxblood10.ogg
voice/default/koraxblood11	sounds/voice/default/demokoraxblood11.ogg
voice/default/koraxblood12	sounds/voice/default/demokoraxblood12.ogg
voice/default/koraxblood13	sounds/voice/default/demokoraxblood13.ogg
voice/default/koraxgame1	sounds/voice/default/demokoraxgame1.ogg
voice/default/koraxgame2	sounds/voice/default/demokoraxgame2.ogg
voice/default/koraxgame3	sounds/voice/default/demokoraxgame3.ogg
voice/default/koraxgame4	sounds/voice/default/demokoraxgame4.ogg
voice/default/koraxgame5	sounds/voice/default/demokoraxgame5.ogg
voice/default/koraxgame6	sounds/voice/default/demokoraxgame6.ogg
voice/default/koraxgame7	sounds/voice/default/demokoraxgame7.ogg
voice/default/koraxgame8	sounds/voice/default/demokoraxgame8.ogg
voice/default/koraxgame9	sounds/voice/default/demokoraxgame9.ogg
voice/default/koraxgame10	sounds/voice/default/demokoraxgame10.ogg
voice/default/koraxgame11	sounds/voice/default/demokoraxgame11.ogg
voice/default/koraxgame12	sounds/voice/default/demokoraxgame12.ogg
voice/default/koraxgame13	sounds/voice/default/demokoraxgame13.ogg
voice/default/koraxgame14	sounds/voice/default/demokoraxgame14.ogg
voice/default/koraxworship1	sounds/voice/default/demokoraxworship1.ogg
voice/default/koraxworship2	sounds/voice/default/demokoraxworship2.ogg
voice/default/koraxworship3	sounds/voice/default/demokoraxworship3.ogg
voice/default/koraxworship4	sounds/voice/default/demokoraxworship4.ogg
voice/default/koraxworship5	sounds/voice/default/demokoraxworship5.ogg
voice/default/koraxworship6	sounds/voice/default/demokoraxworship6.ogg
voice/default/koraxworship7	sounds/voice/default/demokoraxworship7.ogg
voice/default/koraxworship8	sounds/voice/default/demokoraxworship8.ogg
voice/default/koraxworship9	sounds/voice/default/demokoraxworship9.ogg
voice/default/koraxworship10	sounds/voice/default/demokoraxworship10.ogg
voice/default/koraxworship11	sounds/voice/default/demokoraxworship11.ogg
voice/default/koraxmasters1	sounds/voice/default/demokoraxmasters1.ogg
voice/default/koraxmasters2	sounds/voice/default/demokoraxmasters2.ogg
voice/default/koraxmasters3	sounds/voice/default/demokoraxmasters3.ogg
voice/default/koraxmasters4	sounds/voice/default/demokoraxmasters4.ogg
voice/default/koraxmasters5	sounds/voice/default/demokoraxmasters5.ogg
voice/default/koraxmasters6	sounds/voice/default/demokoraxmasters6.ogg
voice/default/koraxmasters7	sounds/voice/default/demokoraxmasters7.ogg
voice/default/koraxmasters8	sounds/voice/default/demokoraxmasters8.ogg
voice/default/koraxmasters9	sounds/voice/default/demokoraxmasters9.ogg
voice/default/giggle1		sounds/voice/default/demogiggle1.ogg
voice/default/giggle2		sounds/voice/default/demogiggle2.ogg
voice/default/giggle3		sounds/voice/default/demogiggle3.ogg
voice/default/giggle4		sounds/voice/default/demogiggle4.ogg
voice/default/giggle5		sounds/voice/default/demogiggle5.ogg
voice/default/giggle6		sounds/voice/default/demogiggle6.ogg
voice/default/giggle7		sounds/voice/default/demogiggle7.ogg
voice/default/giggle8		sounds/voice/default/demogiggle8.ogg
voice/default/giggle9		sounds/voice/default/demogiggle9.ogg
voice/default/giggle10		sounds/voice/default/demogiggle10.ogg
voice/default/giggle11		sounds/voice/default/demogiggle11.ogg
voice/default/giggle12		sounds/voice/default/demogiggle12.ogg
voice/default/giggle13		sounds/voice/default/demogiggle13.ogg
voice/default/giggle14		sounds/voice/default/demogiggle14.ogg
voice/default/giggle15		sounds/voice/default/demogiggle15.ogg
voice/default/giggle16		sounds/voice/default/demogiggle16.ogg
voice/default/giggle17		sounds/voice/default/demogiggle17.ogg
voice/default/giggle18		sounds/voice/default/demogiggle18.ogg
voice/default/giggle19		sounds/voice/default/demogiggle19.ogg
voice/default/hug1		sounds/voice/default/demohug1.ogg
voice/default/hug2		sounds/voice/default/demohug2.ogg
voice/default/hug3		sounds/voice/default/demohug3.ogg
voice/default/hug4		sounds/voice/default/demohug4.ogg
voice/default/hug5		sounds/voice/default/demohug5.ogg
voice/default/hug6		sounds/voice/default/demohug6.ogg
voice/default/hug7		sounds/voice/default/demohug7.ogg
voice/default/hug8		sounds/voice/default/demohug8.ogg
voice/default/hug9		sounds/voice/default/demohug9.ogg

$random voice/default/grunt { voice/default/grunt1 voice/default/grunt2 voice/default/grunt3 voice/default/grunt4 voice/default/grunt5 voice/default/grunt6 }
$random voice/default/lopain { voice/default/lopain1 voice/default/lopain2 voice/default/lopain3 voice/default/lopain4 voice/default/lopain5 }
$random voice/default/pain { voice/default/pain1 voice/default/pain2 voice/default/pain3 voice/default/pain4 voice/default/pain5 }
$random voice/default/hipain { voice/default/hipain1 voice/default/hipain2 voice/default/hipain3 voice/default/hipain4 voice/default/hipain5 }
$random voice/default/death { voice/default/death1 voice/default/death2 voice/default/death3 voice/default/death4 voice/default/death5 }

$random voice/default/giggle { voice/default/giggle1 voice/default/giggle2 voice/default/giggle3 voice/default/giggle4 voice/default/giggle5 voice/default/giggle6 voice/default/giggle7 voice/default/giggle8 voice/default/giggle9 voice/default/giggle10 voice/default/giggle11 voice/default/giggle12 voice/default/giggle13 voice/default/giggle14 voice/default/giggle15 voice/default/giggle16 voice/default/giggle17 voice/default/giggle18 voice/default/giggle19 }
$random voice/default/hug { voice/default/hug1 voice/default/hug2 voice/default/hug3 voice/default/hug4 voice/default/hug5 voice/default/hug6 voice/default/hug7 voice/default/hug8 voice/default/hug9 }
$random voice/default/gigglelow { voice/default/giggle1 voice/default/giggle2 voice/default/giggle5 voice/default/giggle6 voice/default/giggle8 voice/default/giggle10 voice/default/giggle15 voice/default/giggle16 voice/default/giggle18 }
$random voice/default/gigglehigh { voice/default/giggle3 voice/default/giggle4 voice/default/giggle7 voice/default/giggle9 voice/default/giggle11 voice/default/giggle12 voice/default/giggle13 voice/default/giggle14 voice/default/giggle17 }

demolitionist/walk1	sounds/demolitionist/demowalk1.ogg
demolitionist/walk2	sounds/demolitionist/demowalk2.ogg
demolitionist/walk3	sounds/demolitionist/demowalk3.ogg
demolitionist/walk4	sounds/demolitionist/demowalk4.ogg
$random demolitionist/walk { demolitionist/walk1 demolitionist/walk2 demolitionist/walk3 demolitionist/walk4 }
demolitionist/runstart1	sounds/demolitionist/demorunbeg1.ogg
demolitionist/runstart2	sounds/demolitionist/demorunbeg2.ogg
demolitionist/runstart3	sounds/demolitionist/demorunbeg3.ogg
demolitionist/runstart4	sounds/demolitionist/demorunbeg4.ogg
$random demolitionist/runstart { demolitionist/runstart1 demolitionist/runstart2 demolitionist/runstart3 demolitionist/runstart4 }
demolitionist/run1	sounds/demolitionist/demorun1.ogg
demolitionist/run2	sounds/demolitionist/demorun2.ogg
demolitionist/run3	sounds/demolitionist/demorun3.ogg
demolitionist/run4	sounds/demolitionist/demorun4.ogg
$random demolitionist/run { demolitionist/run1 demolitionist/run2 demolitionist/run3 demolitionist/run4 }
demolitionist/runstop1	sounds/demolitionist/demorunstp1.ogg
demolitionist/runstop2	sounds/demolitionist/demorunstp2.ogg
demolitionist/runstop3	sounds/demolitionist/demorunstp3.ogg
demolitionist/runstop4	sounds/demolitionist/demorunstp4.ogg
$random demolitionist/runstop { demolitionist/runstop1 demolitionist/runstop2 demolitionist/runstop3 demolitionist/runstop4 }
demolitionist/jet	sounds/demolitionist/demojet.ogg
demolitionist/jetstop	sounds/demolitionist/demojetstop.ogg
demolitionist/death1	sounds/demolitionist/demodeath1.ogg
demolitionist/death2	sounds/demolitionist/demodeath2.ogg
demolitionist/death3	sounds/demolitionist/demodeath3.ogg
$random demolitionist/death { demolitionist/death1 demolitionist/death2 demolitionist/death3 }
demolitionist/xdeath1	sounds/demolitionist/demoxdeath1.ogg
demolitionist/xdeath2	sounds/demolitionist/demoxdeath2.ogg
demolitionist/xdeath3	sounds/demolitionist/demoxdeath3.ogg
$random demolitionist/xdeath { demolitionist/xdeath1 demolitionist/xdeath2 demolitionist/xdeath3 }
demolitionist/wdeath1	sounds/demolitionist/demowdeath1.ogg
demolitionist/wdeath2	sounds/demolitionist/demowdeath2.ogg
demolitionist/wdeath3	sounds/demolitionist/demowdeath3.ogg
$random demolitionist/wdeath { demolitionist/wdeath1 demolitionist/wdeath2 demolitionist/wdeath3 }
demolitionist/pain1	sounds/demolitionist/demopain1.ogg
demolitionist/pain2	sounds/demolitionist/demopain2.ogg
demolitionist/pain3	sounds/demolitionist/demopain3.ogg
$random demolitionist/pain { demolitionist/pain1 demolitionist/pain2 demolitionist/pain3 }
demolitionist/hipain1	sounds/demolitionist/demohipain1.ogg
demolitionist/hipain2	sounds/demolitionist/demohipain2.ogg
demolitionist/hipain3	sounds/demolitionist/demohipain3.ogg
$random demolitionist/hipain { demolitionist/hipain1 demolitionist/hipain2 demolitionist/hipain3 }
demolitionist/lopain1	sounds/demolitionist/demolopain1.ogg
demolitionist/lopain2	sounds/demolitionist/demolopain2.ogg
demolitionist/lopain3	sounds/demolitionist/demolopain3.ogg
$random demolitionist/lopain { demolitionist/lopain1 demolitionist/lopain2 demolitionist/lopain3 }
demolitionist/hardland1	sounds/demolitionist/demohland1.ogg
demolitionist/hardland2	sounds/demolitionist/demohland2.ogg
demolitionist/hardland3	sounds/demolitionist/demohland3.ogg
$random demolitionist/hardland { demolitionist/hardland1 demolitionist/hardland2 demolitionist/hardland3 }
demolitionist/swing1	sounds/demolitionist/demoswing1.ogg
demolitionist/swing2	sounds/demolitionist/demoswing2.ogg
demolitionist/swing3	sounds/demolitionist/demoswing3.ogg
$random demolitionist/swing { demolitionist/swing1 demolitionist/swing2 demolitionist/swing3 }
demolitionist/wswing1	sounds/demolitionist/demowswing1.ogg
demolitionist/wswing2	sounds/demolitionist/demowswing2.ogg
$random demolitionist/wswing { demolitionist/wswing1 demolitionist/wswing2 }
demolitionist/punch1	sounds/demolitionist/demopunch1.ogg
demolitionist/punch2	sounds/demolitionist/demopunch2.ogg
demolitionist/punch3	sounds/demolitionist/demopunch3.ogg
$random demolitionist/punch { demolitionist/punch1 demolitionist/punch2 demolitionist/punch3 }
demolitionist/punchf1	sounds/demolitionist/demopunchf1.ogg
demolitionist/punchf2	sounds/demolitionist/demopunchf2.ogg
demolitionist/punchf3	sounds/demolitionist/demopunchf3.ogg
$random demolitionist/punchf { demolitionist/punchf1 demolitionist/punchf2 demolitionist/punchf3 }
demolitionist/bump1	sounds/demolitionist/demobump1.ogg
demolitionist/bump2	sounds/demolitionist/demobump2.ogg
demolitionist/bump3	sounds/demolitionist/demobump3.ogg
$random demolitionist/bump { demolitionist/bump1 demolitionist/bump2 demolitionist/bump3 }
demolitionist/kick1	sounds/demolitionist/demokick1.ogg
demolitionist/kick2	sounds/demolitionist/demokick2.ogg
demolitionist/kick3	sounds/demolitionist/demokick3.ogg
$random demolitionist/kick { demolitionist/kick1 demolitionist/kick2 demolitionist/kick3 }
demolitionist/revive	sounds/demolitionist/demorevive.ogg
demolitionist/youdied	sounds/demolitionist/demoded.ogg
demolitionist/parry	sounds/demolitionist/demoparry.ogg
demolitionist/handsup	sounds/demolitionist/demogesturestart.ogg
demolitionist/handsdown	sounds/demolitionist/demogestureend.ogg
demolitionist/whits1	sounds/demolitionist/demowhits1.ogg
demolitionist/whits2	sounds/demolitionist/demowhits2.ogg
demolitionist/whits3	sounds/demolitionist/demowhits3.ogg
$random demolitionist/whits { demolitionist/whits1 demolitionist/whits2 demolitionist/whits3 }
demolitionist/whitm1	sounds/demolitionist/demowhitm1.ogg
demolitionist/whitm2	sounds/demolitionist/demowhitm2.ogg
demolitionist/whitm3	sounds/demolitionist/demowhitm3.ogg
$random demolitionist/whitm { demolitionist/whitm1 demolitionist/whitm2 demolitionist/whitm3 }
demolitionist/whitl1	sounds/demolitionist/demowhitl1.ogg
demolitionist/whitl2	sounds/demolitionist/demowhitl2.ogg
$random demolitionist/whitl { demolitionist/whitl1 demolitionist/whitl2 }
demolitionist/buttslam1	sounds/demolitionist/demobutt1.ogg
demolitionist/buttslam2	sounds/demolitionist/demobutt2.ogg
demolitionist/buttslam3	sounds/demolitionist/demobutt3.ogg
$random demolitionist/buttslam { demolitionist/buttslam1 demolitionist/buttslam2 demolitionist/buttslam3 }
demolitionist/buttslamx	sounds/demolitionist/demoxbutt.ogg
demolitionist/smooch	sounds/demolitionist/demokiss.ogg
demolitionist/blowkiss	sounds/demolitionist/demoblow.ogg
demolitionist/petting	sounds/demolitionist/demopat.ogg
demolitionist/knockout	sounds/demolitionist/demoknockout.ogg

$playersound demolitionist neutral *grunt	DSEMPTY
$playeralias demolitionist neutral *pain100	demolitionist/lopain
$playeralias demolitionist neutral *pain75	demolitionist/pain
$playeralias demolitionist neutral *pain50	demolitionist/pain
$playeralias demolitionist neutral *pain25	demolitionist/hipain
$playersound demolitionist neutral *usefail	sounds/menu/failuse.ogg
$playeralias demolitionist neutral *death	demolitionist/death
$playeralias demolitionist neutral *burndeath	demolitionist/death
$playeralias demolitionist neutral *xdeath	demolitionist/xdeath
$playeralias demolitionist neutral *gibbed	demolitionist/xdeath
$playeralias demolitionist neutral *crazydeath	demolitionist/xdeath
$playeralias demolitionist neutral *wimpydeath	demolitionist/wdeath
$playersound demolitionist neutral *land	DSEMPTY
$playersound demolitionist neutral *falling	DSEMPTY
$playersound demolitionist neutral *puzzfail	sounds/menu/failuse.ogg
$playersound demolitionist neutral *poison	DSEMPTY
$playersound demolitionist neutral *dive	DSEMPTY
$playersound demolitionist neutral *surface	DSEMPTY
$playersound demolitionist neutral *gasp	DSEMPTY
$playersound demolitionist neutral *taunt	DSEMPTY
$playersound demolitionist neutral *evillaugh	DSEMPTY

deepimpact/fire		sounds/deepimpact/impfire.ogg
deepimpact/charge	sounds/deepimpact/impaltcharge.ogg
deepimpact/altfire	sounds/deepimpact/impaltfire.ogg
deepimpact/dryfire	sounds/deepimpact/impdryfire.ogg
deepimpact/select	sounds/deepimpact/impsel.ogg
deepimpact/checkout	sounds/deepimpact/impidle.ogg
deepimpact/deselect	sounds/deepimpact/impdown.ogg
deepimpact/bullet	sounds/deepimpact/impbulletfly.ogg
deepimpact/bullethit1	sounds/deepimpact/impexplo1.ogg
deepimpact/bullethit2	sounds/deepimpact/impexplo2.ogg
deepimpact/reloadbeg	sounds/deepimpact/impreloadstart.ogg
deepimpact/reloadend	sounds/deepimpact/impreloadend.ogg
deepimpact/reload	sounds/deepimpact/impcrank.ogg
deepimpact/noreload	sounds/deepimpact/impcrankhalt.ogg
$random deepimpact/bullethit { deepimpact/bullethit1 deepimpact/bullethit2 }

explodium/casing1	sounds/explodiumgun/expl_case1.ogg
explodium/casing2	sounds/explodiumgun/expl_case2.ogg
explodium/casing3	sounds/explodiumgun/expl_case3.ogg
explodium/casing4	sounds/explodiumgun/expl_case4.ogg
$random explodium/casing { explodium/casing1 explodium/casing2 explodium/casing3 explodium/casing4 }
explodium/checkout	sounds/explodiumgun/expl_checkout.ogg
explodium/fire1		sounds/explodiumgun/expl_fire1.ogg
explodium/fire2		sounds/explodiumgun/expl_fire2.ogg
explodium/fire3		sounds/explodiumgun/expl_fire3.ogg
$random explodium/fire { explodium/fire1 explodium/fire2 explodium/fire3 }
explodium/hit1		sounds/explodiumgun/expl_hit1.ogg
explodium/hit2		sounds/explodiumgun/expl_hit2.ogg
explodium/hit3		sounds/explodiumgun/expl_hit3.ogg
$random explodium/hit { explodium/hit1 explodium/hit2 explodium/hit3 }
explodium/jamitin	sounds/explodiumgun/expl_jamitin.ogg
explodium/mag1		sounds/explodiumgun/expl_mag1.ogg
explodium/mag2		sounds/explodiumgun/expl_mag2.ogg
explodium/mag3		sounds/explodiumgun/expl_mag3.ogg
$random explodium/mag { explodium/mag1 explodium/mag2 explodium/mag3 }
explodium/maghit1	sounds/explodiumgun/expl_maghit1.ogg
explodium/maghit2	sounds/explodiumgun/expl_maghit2.ogg
$random explodium/maghit { explodium/maghit1 explodium/maghit2 }
explodium/magget	sounds/explodiumgun/expl_magget.ogg
explodium/magin		sounds/explodiumgun/expl_magin.ogg
explodium/magout	sounds/explodiumgun/expl_magout.ogg
explodium/magpin	sounds/explodiumgun/expl_magpin.ogg
explodium/select	sounds/explodiumgun/expl_select.ogg
explodium/deselect	sounds/explodiumgun/expl_deselect.ogg
explodium/slideback	sounds/explodiumgun/expl_slideback.ogg
explodium/slideforward	sounds/explodiumgun/expl_slideforward.ogg
explodium/slidelock	sounds/explodiumgun/expl_slidelock.ogg
explodium/speen		sounds/explodiumgun/expl_speen.ogg
explodium/throwmag	sounds/explodiumgun/expl_throwmag.ogg
$limit explodium/hit 32
$limit explodium/maghit 32

pusher/select	sounds/pusher/push_select.ogg
pusher/deselect	sounds/pusher/push_deselect.ogg
pusher/motor	sounds/pusher/push_motor.ogg
pusher/motorend	sounds/pusher/push_motorend.ogg
pusher/start	sounds/pusher/push_start.ogg
pusher/drill	sounds/pusher/push_drill.ogg
pusher/hit1	sounds/pusher/push_hitw1.ogg
pusher/hit2	sounds/pusher/push_hitw2.ogg
pusher/hit3	sounds/pusher/push_hitw3.ogg
$random pusher/hit { pusher/hit1 pusher/hit2 pusher/hit3 }
$limit pusher/hit 32
pusher/meat1	sounds/pusher/push_hitf1.ogg
pusher/meat2	sounds/pusher/push_hitf2.ogg
pusher/meat3	sounds/pusher/push_hitf3.ogg
$random pusher/meat { pusher/meat1 pusher/meat2 pusher/meat3 }
$limit pusher/meat 32
pusher/end	sounds/pusher/push_end.ogg
pusher/checkout	sounds/pusher/push_idle.ogg
pusher/pullback	sounds/pusher/push_altcharge.ogg
pusher/altfire1	sounds/pusher/push_altfire1.ogg
pusher/altfire2	sounds/pusher/push_altfire2.ogg
$random pusher/altfire { pusher/altfire1 pusher/altfire2 }
pusher/miss	sounds/pusher/push_miss.ogg
pusher/althit1	sounds/pusher/push_slam1.ogg
pusher/althit2	sounds/pusher/push_slam2.ogg
$random pusher/althit { pusher/althit1 pusher/althit2 }
pusher/altmeat1	sounds/pusher/push_slamf1.ogg
pusher/altmeat2	sounds/pusher/push_slamf2.ogg
$random pusher/altmeat { pusher/altmeat1 pusher/altmeat2 }
pusher/fly	sounds/pusher/push_fly.ogg
pusher/bounce1	sounds/pusher/push_bounce1.ogg
pusher/bounce2	sounds/pusher/push_bounce2.ogg
pusher/bounce3	sounds/pusher/push_bounce3.ogg
$random pusher/bounce { pusher/bounce1 pusher/bounce2 pusher/bounce3 }

spreadgun/open		sounds/spreadgun/spread_open.ogg
spreadgun/hammer	sounds/spreadgun/spread_hammer.ogg
spreadgun/close		sounds/spreadgun/spread_close.ogg
spreadgun/shellin	sounds/spreadgun/spread_load.ogg
spreadgun/select	sounds/spreadgun/spread_select.ogg
spreadgun/deselect	sounds/spreadgun/spread_deselect.ogg
spreadgun/redfire1	sounds/spreadgun/spread_redfire1.ogg
spreadgun/redfire2	sounds/spreadgun/spread_redfire2.ogg
$random spreadgun/redfire { spreadgun/redfire1 spreadgun/redfire2 }
$limit spreadgun/redfire 16
spreadgun/greenfire1	sounds/spreadgun/spread_greenfire1.ogg
spreadgun/greenfire2	sounds/spreadgun/spread_greenfire2.ogg
$random spreadgun/greenfire { spreadgun/greenfire1 spreadgun/greenfire2 }
$limit spreadgun/greenfire 16
spreadgun/whitefire1	sounds/spreadgun/spread_whitefire1.ogg
spreadgun/whitefire2	sounds/spreadgun/spread_whitefire2.ogg
$random spreadgun/whitefire { spreadgun/whitefire1 spreadgun/whitefire2 }
spreadgun/bluefire1	sounds/spreadgun/spread_bluefire1.ogg
spreadgun/bluefire2	sounds/spreadgun/spread_bluefire2.ogg
$random spreadgun/bluefire { spreadgun/bluefire1 spreadgun/bluefire2 }
$limit spreadgun/bluefire 16
spreadgun/blackfire1	sounds/spreadgun/spread_blackfire1.ogg
spreadgun/blackfire2	sounds/spreadgun/spread_blackfire2.ogg
$random spreadgun/blackfire { spreadgun/blackfire1 spreadgun/blackfire2 }
spreadgun/purplefire1	sounds/spreadgun/spread_purplefire1.ogg
spreadgun/purplefire2	sounds/spreadgun/spread_purplefire2.ogg
$random spreadgun/purplefire { spreadgun/purplefire1 spreadgun/purplefire2 }
$limit spreadgun/purplefire 16
spreadgun/goldfire1	sounds/spreadgun/spread_goldfire1.ogg
spreadgun/goldfire2	sounds/spreadgun/spread_goldfire2.ogg
$random spreadgun/goldfire { spreadgun/goldfire1 spreadgun/goldfire2 }
spreadgun/checkgun	sounds/spreadgun/spread_idle.ogg
spreadgun/casing1	sounds/spreadgun/spread_casing1.ogg
spreadgun/casing2	sounds/spreadgun/spread_casing2.ogg
spreadgun/casing3	sounds/spreadgun/spread_casing3.ogg
spreadgun/casing4	sounds/spreadgun/spread_casing4.ogg
spreadgun/casing5	sounds/spreadgun/spread_casing5.ogg
spreadgun/casing6	sounds/spreadgun/spread_casing6.ogg
$random spreadgun/casing { spreadgun/casing1 spreadgun/casing2 spreadgun/casing3 spreadgun/casing4 spreadgun/casing5 spreadgun/casing6 }
spreadgun/gcasing1	sounds/spreadgun/spread_gcasing1.ogg
spreadgun/gcasing2	sounds/spreadgun/spread_gcasing2.ogg
spreadgun/gcasing3	sounds/spreadgun/spread_gcasing3.ogg
$random spreadgun/gcasing { spreadgun/gcasing1 spreadgun/gcasing2 spreadgun/gcasing3 }
spreadgun/pellet1	sounds/spreadgun/spread_pellet1.ogg
spreadgun/pellet2	sounds/spreadgun/spread_pellet2.ogg
spreadgun/pellet3	sounds/spreadgun/spread_pellet3.ogg
spreadgun/pellet4	sounds/spreadgun/spread_pellet4.ogg
spreadgun/pellet5	sounds/spreadgun/spread_pellet5.ogg
spreadgun/pellet6	sounds/spreadgun/spread_pellet6.ogg
spreadgun/pellet7	sounds/spreadgun/spread_pellet7.ogg
spreadgun/pellet8	sounds/spreadgun/spread_pellet8.ogg
$random spreadgun/pellet { spreadgun/pellet1 spreadgun/pellet2 spreadgun/pellet3 spreadgun/pellet4 spreadgun/pellet5 spreadgun/pellet6 spreadgun/pellet7 spreadgun/pellet8 }
$limit spreadgun/pellet 32
spreadgun/pelletf1	sounds/spreadgun/spread_pelletf1.ogg
spreadgun/pelletf2	sounds/spreadgun/spread_pelletf2.ogg
spreadgun/pelletf3	sounds/spreadgun/spread_pelletf3.ogg
spreadgun/pelletf4	sounds/spreadgun/spread_pelletf4.ogg
spreadgun/pelletf5	sounds/spreadgun/spread_pelletf5.ogg
spreadgun/pelletf6	sounds/spreadgun/spread_pelletf6.ogg
$random spreadgun/pelletf { spreadgun/pelletf1 spreadgun/pelletf2 spreadgun/pelletf3 spreadgun/pelletf4 spreadgun/pelletf5 spreadgun/pelletf6 }
$limit spreadgun/pelletf 32
spreadgun/slug1		sounds/spreadgun/spread_slug1.ogg
spreadgun/slug2		sounds/spreadgun/spread_slug2.ogg
$random spreadgun/slug { spreadgun/slug1 spreadgun/slug2 }
spreadgun/slugf1	sounds/spreadgun/spread_slugf1.ogg
spreadgun/slugf2	sounds/spreadgun/spread_slugf2.ogg
$random spreadgun/slugf { spreadgun/slugf1 spreadgun/slugf2 }
spreadgun/corrode	sounds/spreadgun/spread_poison.ogg
spreadgun/corrodepuff1	sounds/spreadgun/spread_poisonpuff1.ogg
spreadgun/corrodepuff2	sounds/spreadgun/spread_poisonpuff2.ogg
$random spreadgun/corrodepuff { spreadgun/corrodepuff1 spreadgun/corrodepuff2 }
$limit spreadgun/corrodepuff 32
spreadgun/ball1		sounds/spreadgun/spread_ball1.ogg
spreadgun/ball2		sounds/spreadgun/spread_ball2.ogg
spreadgun/ball3		sounds/spreadgun/spread_ball3.ogg
$random spreadgun/ball { spreadgun/ball1 spreadgun/ball2 spreadgun/ball3 }
spreadgun/ballf1	sounds/spreadgun/spread_ballf1.ogg
spreadgun/ballf2	sounds/spreadgun/spread_ballf2.ogg
spreadgun/ballf3	sounds/spreadgun/spread_ballf3.ogg
$random spreadgun/ballf { spreadgun/ballf1 spreadgun/ballf2 spreadgun/ballf3 }
spreadgun/salt1		sounds/spreadgun/spread_salt1.ogg
spreadgun/salt2		sounds/spreadgun/spread_salt2.ogg
spreadgun/salt3		sounds/spreadgun/spread_salt3.ogg
spreadgun/salt4		sounds/spreadgun/spread_salt4.ogg
$random spreadgun/salt { spreadgun/salt1 spreadgun/salt2 spreadgun/salt3 spreadgun/salt4 }
$limit spreadgun/salt 32
spreadgun/salttrail1	sounds/spreadgun/spread_bluetrail1.ogg
spreadgun/salttrail2	sounds/spreadgun/spread_bluetrail2.ogg
spreadgun/salttrail3	sounds/spreadgun/spread_bluetrail3.ogg
spreadgun/salttrail4	sounds/spreadgun/spread_bluetrail4.ogg
$random spreadgun/salttrail { spreadgun/salttrail1 spreadgun/salttrail2 spreadgun/salttrail3 spreadgun/salttrail4 }
$limit spreadgun/salttrail 32
spreadgun/goldexpl1	sounds/spreadgun/spread_goldexp1.ogg
spreadgun/goldexpl2	sounds/spreadgun/spread_goldexp2.ogg
$random spreadgun/goldexpl { spreadgun/goldexpl1 spreadgun/goldexpl2 }

wallbuster/select	sounds/wallbuster/cbt_select.ogg
wallbuster/deselect	sounds/wallbuster/cbt_deselect.ogg
wallbuster/dryfire	sounds/wallbuster/cbt_dryfire.ogg
wallbuster/spin		sounds/wallbuster/cbt_spinone.ogg
wallbuster/spinbig	sounds/wallbuster/cbt_spinbig.ogg
wallbuster/unlock	sounds/wallbuster/cbt_leverpull.ogg
wallbuster/lock		sounds/wallbuster/cbt_leverpush.ogg
wallbuster/meleestart	sounds/wallbuster/cbt_lower.ogg
wallbuster/meleeend	sounds/wallbuster/cbt_raise.ogg
wallbuster/detach	sounds/wallbuster/cbt_unload.ogg
wallbuster/attach	sounds/wallbuster/cbt_load.ogg
wallbuster/handspin	sounds/wallbuster/cbt_handspin.ogg
wallbuster/load1	sounds/wallbuster/cbt_shellin1.ogg
wallbuster/load2	sounds/wallbuster/cbt_shellin2.ogg
wallbuster/load3	sounds/wallbuster/cbt_shellin3.ogg
wallbuster/load4	sounds/wallbuster/cbt_shellin4.ogg
$random wallbuster/load { wallbuster/load1 wallbuster/load2 wallbuster/load3 wallbuster/load4 }
wallbuster/smallbust1	sounds/wallbuster/cbt_smallbust1.ogg
wallbuster/smallbust2	sounds/wallbuster/cbt_smallbust2.ogg
wallbuster/smallbust3	sounds/wallbuster/cbt_smallbust3.ogg
$random wallbuster/smallbust { wallbuster/smallbust1 wallbuster/smallbust2 wallbuster/smallbust3 }
$limit wallbuster/smallbust 16
wallbuster/bigbust1	sounds/wallbuster/cbt_bigbust1.ogg
wallbuster/bigbust2	sounds/wallbuster/cbt_bigbust2.ogg
wallbuster/bigbust3	sounds/wallbuster/cbt_bigbust3.ogg
$random wallbuster/bigbust { wallbuster/bigbust1 wallbuster/bigbust2 wallbuster/bigbust3 }
$limit wallbuster/bigbust 8

eviscerator/select	sounds/eviscerator/visc_select.ogg
eviscerator/deselect	sounds/eviscerator/visc_deselect.ogg
eviscerator/load	sounds/eviscerator/visc_cycle.ogg
eviscerator/fire1	sounds/eviscerator/visc_fire1.ogg
eviscerator/fire2	sounds/eviscerator/visc_fire2.ogg
$random eviscerator/fire { eviscerator/fire1 eviscerator/fire2 }
eviscerator/altfire1	sounds/eviscerator/visc_altfire1.ogg
eviscerator/altfire2	sounds/eviscerator/visc_altfire2.ogg
$random eviscerator/altfire { eviscerator/altfire1 eviscerator/altfire2 }
eviscerator/eject	sounds/eviscerator/visc_eject.ogg
eviscerator/ejectend	sounds/eviscerator/visc_ejectend.ogg
eviscerator/switch	sounds/eviscerator/visc_switch.ogg
eviscerator/checkgun	sounds/eviscerator/visc_idle.ogg
eviscerator/meleestart	sounds/eviscerator/visc_meleestart.ogg
eviscerator/meleeend	sounds/eviscerator/visc_meleeend.ogg
eviscerator/hit1	sounds/eviscerator/visc_hit1.ogg
eviscerator/hit2	sounds/eviscerator/visc_hit2.ogg
eviscerator/hit3	sounds/eviscerator/visc_hit3.ogg
eviscerator/hit4	sounds/eviscerator/visc_hit4.ogg
eviscerator/hit5	sounds/eviscerator/visc_hit5.ogg
eviscerator/hit6	sounds/eviscerator/visc_hit6.ogg
$random eviscerator/hit { eviscerator/hit1 eviscerator/hit2 eviscerator/hit3 eviscerator/hit4 eviscerator/hit5 eviscerator/hit6 }
$limit eviscerator/hit 32
eviscerator/hith1	sounds/eviscerator/visc_hith1.ogg
eviscerator/hith2	sounds/eviscerator/visc_hith2.ogg
eviscerator/hith3	sounds/eviscerator/visc_hith3.ogg
eviscerator/hith4	sounds/eviscerator/visc_hith4.ogg
eviscerator/hith5	sounds/eviscerator/visc_hith5.ogg
eviscerator/hith6	sounds/eviscerator/visc_hith6.ogg
eviscerator/hith7	sounds/eviscerator/visc_hith7.ogg
eviscerator/hith8	sounds/eviscerator/visc_hith8.ogg
$random eviscerator/hith { eviscerator/hith1 eviscerator/hith2 eviscerator/hith3 eviscerator/hith4 eviscerator/hith5 eviscerator/hith6 eviscerator/hith7 eviscerator/hith8 }
$limit eviscerator/hith 32
eviscerator/hitf1	sounds/eviscerator/visc_hitf1.ogg
eviscerator/hitf2	sounds/eviscerator/visc_hitf2.ogg
eviscerator/hitf3	sounds/eviscerator/visc_hitf3.ogg
$random eviscerator/hitf { eviscerator/hitf1 eviscerator/hitf2 eviscerator/hitf3 }
$limit eviscerator/hitf 32
eviscerator/shell1	sounds/eviscerator/visc_shell1.ogg
eviscerator/shell2	sounds/eviscerator/visc_shell2.ogg
$random eviscerator/shell { eviscerator/shell1 eviscerator/shell2 }
eviscerator/casing	sounds/eviscerator/visc_casing.ogg

hellblazer/select	sounds/hellblazer/blaze_select.ogg
hellblazer/deselect	sounds/hellblazer/blaze_deselect.ogg
hellblazer/fire		sounds/hellblazer/blaze_fire.ogg
hellblazer/altfire	sounds/hellblazer/blaze_altfire.ogg
hellblazer/meleestart	sounds/hellblazer/blaze_meleestart.ogg
hellblazer/meleeend	sounds/hellblazer/blaze_meleeend.ogg
hellblazer/idle		sounds/hellblazer/blaze_idle.ogg
hellblazer/dustoff	sounds/hellblazer/blaze_dustoff.ogg
hellblazer/shift	sounds/hellblazer/blaze_shift.ogg
hellblazer/spin		sounds/hellblazer/blaze_spin.ogg
hellblazer/open		sounds/hellblazer/blaze_open.ogg
hellblazer/magout	sounds/hellblazer/blaze_magout.ogg
hellblazer/magin	sounds/hellblazer/blaze_magin.ogg
hellblazer/close	sounds/hellblazer/blaze_close.ogg
hellblazer/hitm1	sounds/hellblazer/blaze_hitm1.ogg
hellblazer/hitm2	sounds/hellblazer/blaze_hitm2.ogg
hellblazer/hitm3	sounds/hellblazer/blaze_hitm3.ogg
$random hellblazer/hitm { hellblazer/hitm1 hellblazer/hitm2 hellblazer/hitm3 }
$limit hellblazer/hitm 32
hellblazer/hitc1	sounds/hellblazer/blaze_hitc1.ogg
hellblazer/hitc2	sounds/hellblazer/blaze_hitc2.ogg
hellblazer/hitc3	sounds/hellblazer/blaze_hitc3.ogg
$random hellblazer/hitc { hellblazer/hitc1 hellblazer/hitc2 hellblazer/hitc3 }
$limit hellblazer/hitc 32
hellblazer/hitcs1	sounds/hellblazer/blaze_hitcs1.ogg
hellblazer/hitcs2	sounds/hellblazer/blaze_hitcs2.ogg
hellblazer/hitcs3	sounds/hellblazer/blaze_hitcs3.ogg
$random hellblazer/hitcs { hellblazer/hitcs1 hellblazer/hitcs2 hellblazer/hitcs3 }
$limit hellblazer/hitcs 32
hellblazer/hitr1	sounds/hellblazer/blaze_hitr1.ogg
hellblazer/hitr2	sounds/hellblazer/blaze_hitr2.ogg
hellblazer/hitr3	sounds/hellblazer/blaze_hitr3.ogg
$random hellblazer/hitr { hellblazer/hitr1 hellblazer/hitr2 hellblazer/hitr3 }
$limit hellblazer/hitr 32
hellblazer/hitw1	sounds/hellblazer/blaze_hitw1.ogg
hellblazer/hitw2	sounds/hellblazer/blaze_hitw2.ogg
$random hellblazer/hitw { hellblazer/hitw1 hellblazer/hitw2 }
$limit hellblazer/hitw 32
hellblazer/bounce	sounds/hellblazer/blaze_bounce.ogg
hellblazer/fly		sounds/hellblazer/blaze_fly.ogg
hellblazer/preload	sounds/hellblazer/blaze_preload.ogg
hellblazer/hold		sounds/hellblazer/blaze_hold.ogg
hellblazer/lock		sounds/hellblazer/blaze_lock.ogg
hellblazer/clear	sounds/hellblazer/blaze_clear.ogg

biospark/select		sounds/sparkster/spark_select.ogg
biospark/deselect	sounds/sparkster/spark_deselect.ogg
biospark/fire1		sounds/sparkster/spark_fire1.ogg
biospark/fire2		sounds/sparkster/spark_fire2.ogg
biospark/fire3		sounds/sparkster/spark_fire3.ogg
$random biospark/fire { biospark/fire1 biospark/fire2 biospark/fire3 }
biospark/altfire1	sounds/sparkster/spark_altfire1.ogg
biospark/altfire2	sounds/sparkster/spark_altfire2.ogg
biospark/altfire3	sounds/sparkster/spark_altfire3.ogg
$random biospark/altfire { biospark/altfire1 biospark/altfire2 biospark/altfire3 }
biospark/thirdfire	sounds/sparkster/spark_third.ogg
biospark/meleestart	sounds/sparkster/spark_meleestart.ogg
biospark/meleeend	sounds/sparkster/spark_meleeend.ogg
biospark/idle		sounds/sparkster/spark_idle.ogg
biospark/idle2		sounds/sparkster/spark_idle2.ogg
biospark/magout		sounds/sparkster/spark_magout.ogg
biospark/magin		sounds/sparkster/spark_magin.ogg
biospark/spark		sounds/sparkster/spark_spark.ogg
biospark/hit1		sounds/sparkster/spark_hit1.ogg
biospark/hit2		sounds/sparkster/spark_hit2.ogg
biospark/hit3		sounds/sparkster/spark_hit3.ogg
$random biospark/hit { biospark/hit1 biospark/hit2 biospark/hit3 }
$limit biospark/hit 32
biospark/beamhit1	sounds/sparkster/spark_beamhit1.ogg
biospark/beamhit2	sounds/sparkster/spark_beamhit2.ogg
$random biospark/beamhit { biospark/beamhit1 biospark/beamhit2 }
$limit biospark/beamhit 32
biospark/deploy1	sounds/sparkster/spark_deploy1.ogg
biospark/deploy2	sounds/sparkster/spark_deploy2.ogg
biospark/deploy3	sounds/sparkster/spark_deploy3.ogg
$random biospark/deploy { biospark/deploy1 biospark/deploy2 biospark/deploy3 }
$limit biospark/deploy 32
biospark/bighit1	sounds/sparkster/spark_bigexpl1.ogg
biospark/bighit2	sounds/sparkster/spark_bigexpl2.ogg
$random biospark/bighit { biospark/bighit1 biospark/bighit2 }
$limit biospark/bighit 32
biospark/bigspark	sounds/sparkster/spark_bigspark.ogg
biospark/arc1		sounds/sparkster/spark_arc1.ogg
biospark/arc2		sounds/sparkster/spark_arc2.ogg
biospark/arc3		sounds/sparkster/spark_arc3.ogg
biospark/arc4		sounds/sparkster/spark_arc4.ogg
$random biospark/arc { biospark/arc1 biospark/arc2 biospark/arc3 biospark/arc4 }
$limit biospark/arc 64
biospark/bigarc1	sounds/sparkster/spark_arcb1.ogg
biospark/bigarc2	sounds/sparkster/spark_arcb2.ogg
biospark/bigarc3	sounds/sparkster/spark_arcb3.ogg
biospark/bigarc4	sounds/sparkster/spark_arcb4.ogg
$random biospark/bigarc { biospark/bigarc1 biospark/bigarc2 biospark/bigarc3 biospark/bigarc4 }
$limit biospark/bigarc 64
biospark/hugearc1	sounds/sparkster/spark_arch1.ogg
biospark/hugearc2	sounds/sparkster/spark_arch2.ogg
biospark/hugearc3	sounds/sparkster/spark_arch3.ogg
$random biospark/hugearc { biospark/hugearc1 biospark/hugearc2 biospark/hugearc3 }
$limit biospark/hugearc 64
biospark/zap1		sounds/sparkster/spark_zap1.ogg
biospark/zap2		sounds/sparkster/spark_zap2.ogg
biospark/zap3		sounds/sparkster/spark_zap3.ogg
biospark/zap4		sounds/sparkster/spark_zap4.ogg
biospark/zap5		sounds/sparkster/spark_zap5.ogg
biospark/zap6		sounds/sparkster/spark_zap6.ogg
$random biospark/zap { biospark/zap1 biospark/zap2 biospark/zap3 biospark/zap4 biospark/zap5 biospark/zap6 }
$limit biospark/zap 64
biospark/prefire	sounds/sparkster/spark_prefire.ogg
biospark/prethird	sounds/sparkster/spark_prethird.ogg
biospark/hiss		sounds/sparkster/spark_hiss.ogg
biospark/fail		sounds/sparkster/spark_thirdfail.ogg
biospark/checkout	sounds/sparkster/spark_checkout.ogg

silverbullet/select	sounds/silverbullet/silver_select.ogg
silverbullet/deselect	sounds/silverbullet/silver_deselect.ogg
silverbullet/meleestart	sounds/silverbullet/silver_meleestart.ogg
silverbullet/meleeend	sounds/silverbullet/silver_meleeend.ogg
silverbullet/idle	sounds/silverbullet/silver_idle.ogg
silverbullet/boltopen	sounds/silverbullet/silver_boltopen.ogg
silverbullet/boltclose	sounds/silverbullet/silver_boltclose.ogg
silverbullet/magout	sounds/silverbullet/silver_magout.ogg
silverbullet/magin	sounds/silverbullet/silver_magin.ogg
silverbullet/zoomstart	sounds/silverbullet/silver_zoomstart.ogg
silverbullet/zooming	sounds/silverbullet/silver_zooming.ogg
silverbullet/zoomend	sounds/silverbullet/silver_zoomend.ogg
silverbullet/fire1	sounds/silverbullet/silver_fire1.ogg
silverbullet/fire2	sounds/silverbullet/silver_fire2.ogg
silverbullet/fire3	sounds/silverbullet/silver_fire3.ogg
$random silverbullet/fire { silverbullet/fire1 silverbullet/fire2 silverbullet/fire3 }
silverbullet/altfire1	sounds/silverbullet/silver_altfire1.ogg
silverbullet/altfire2	sounds/silverbullet/silver_altfire2.ogg
silverbullet/altfire3	sounds/silverbullet/silver_altfire3.ogg
$random silverbullet/altfire { silverbullet/altfire1 silverbullet/altfire2 silverbullet/altfire3 }
silverbullet/jet	sounds/silverbullet/silver_jet.ogg
silverbullet/casing1	sounds/silverbullet/silver_casing1.ogg
silverbullet/casing2	sounds/silverbullet/silver_casing2.ogg
silverbullet/casing3	sounds/silverbullet/silver_casing3.ogg
silverbullet/casing4	sounds/silverbullet/silver_casing4.ogg
$random silverbullet/casing { silverbullet/casing1 silverbullet/casing2 silverbullet/casing3 silverbullet/casing4 }
silverbullet/mag1	sounds/silverbullet/silver_mag1.ogg
silverbullet/mag2	sounds/silverbullet/silver_mag2.ogg
silverbullet/mag3	sounds/silverbullet/silver_mag3.ogg
$random silverbullet/mag { silverbullet/mag1 silverbullet/mag2 silverbullet/mag3 }
silverbullet/hit1	sounds/silverbullet/silver_hit1.ogg
silverbullet/hit2	sounds/silverbullet/silver_hit2.ogg
$random silverbullet/hit { silverbullet/hit1 silverbullet/hit2 }
silverbullet/flesh1	sounds/silverbullet/silver_hitf1.ogg
silverbullet/flesh2	sounds/silverbullet/silver_hitf2.ogg
$random silverbullet/flesh { silverbullet/flesh1 silverbullet/flesh2 }
silverbullet/chode1	sounds/silverbullet/silver_chode1.ogg
silverbullet/chode2	sounds/silverbullet/silver_chode2.ogg
$random silverbullet/chode { silverbullet/chode1 silverbullet/chode2 }
silverbullet/crouch	sounds/silverbullet/silver_crouch.ogg
silverbullet/uncrouch	sounds/silverbullet/silver_uncrouch.ogg

candygun/fire1		sounds/candygun/candy_fire1.ogg
candygun/fire2		sounds/candygun/candy_fire2.ogg
candygun/fire3		sounds/candygun/candy_fire3.ogg
$random candygun/fire { candygun/fire1 candygun/fire2 candygun/fire3 }
candygun/hit1		sounds/candygun/candy_hit1.ogg
candygun/hit2		sounds/candygun/candy_hit2.ogg
candygun/hit3		sounds/candygun/candy_hit3.ogg
$random candygun/hit { candygun/hit1 candygun/hit2 candygun/hit3 }
candygun/maghit1	sounds/candygun/candy_maghit1.ogg
candygun/maghit2	sounds/candygun/candy_maghit2.ogg
$random candygun/maghit { candygun/maghit1 candygun/maghit2 }
candygun/gunhit1	sounds/candygun/candy_gunhit1.ogg
candygun/gunhit2	sounds/candygun/candy_gunhit2.ogg
$random candygun/gunhit { candygun/gunhit1 candygun/gunhit2 }
$limit candygun/hit 32
$limit candygun/maghit 32
$limit candygun/gunhit 32

ynykron/select		sounds/ynykron/mc_select.ogg
ynykron/deselect	sounds/ynykron/mc_deselect.ogg
ynykron/idle		sounds/ynykron/mc_idle.ogg
ynykron/ready		sounds/ynykron/mc_ready.ogg
ynykron/latch		sounds/ynykron/mc_latch.ogg
ynykron/ventopen	sounds/ynykron/mc_ventopen.ogg
ynykron/ventclose	sounds/ynykron/mc_ventclose.ogg
ynykron/puff		sounds/ynykron/mc_puff.ogg
ynykron/puffing		sounds/ynykron/mc_puffing.ogg
ynykron/puffend		sounds/ynykron/mc_puffend.ogg
ynykron/meleestart	sounds/ynykron/mc_meleestart.ogg
ynykron/meleeend	sounds/ynykron/mc_meleeend.ogg
ynykron/checkout	sounds/ynykron/mc_checkout.ogg
ynykron/fire		sounds/ynykron/mc_fire.ogg
ynykron/altfire		sounds/ynykron/mc_altfire.ogg
ynykron/magout		sounds/ynykron/mc_magout.ogg
ynykron/magin		sounds/ynykron/mc_magin.ogg
ynykron/beam		sounds/ynykron/mc_beam.ogg
ynykron/hit1		sounds/ynykron/mc_hit1.ogg
ynykron/hit2		sounds/ynykron/mc_hit2.ogg
ynykron/hit3		sounds/ynykron/mc_hit3.ogg
$random ynykron/hit { ynykron/hit1 ynykron/hit2 ynykron/hit3 }
ynykron/altbeam		sounds/ynykron/mc_altbeam.ogg
ynykron/vortex		sounds/ynykron/mc_vortex.ogg
ynykron/vortexarc1	sounds/ynykron/mc_vortexarc1.ogg
ynykron/vortexarc2	sounds/ynykron/mc_vortexarc2.ogg
ynykron/vortexarc3	sounds/ynykron/mc_vortexarc3.ogg
$random ynykron/vortexarc { ynykron/vortexarc1 ynykron/vortexarc2 ynykron/vortexarc3 }
ynykron/vortexflash1	sounds/ynykron/mc_vortexflash1.ogg
ynykron/vortexflash2	sounds/ynykron/mc_vortexflash2.ogg
$random ynykron/vortexflash { ynykron/vortexflash1 ynykron/vortexflash2 }
ynykron/vortexend	sounds/ynykron/mc_vortexend.ogg
ynykron/wind		sounds/ynykron/mc_vortexwind.ogg

misc/secret		sounds/menu/findsecret.ogg
misc/keytry		sounds/menu/failuse.ogg
misc/w_pkup		sounds/general/wpickup.ogg
misc/p_pkup		sounds/general/ppickup.ogg
misc/i_pkup		sounds/general/ipickup.ogg
misc/k_pkup		sounds/general/kpickup.ogg
misc/ammo_pkup		sounds/general/apickup.ogg
misc/bullet_pkup	sounds/general/bpickup.ogg
misc/armor_pkup		sounds/general/spickup.ogg
misc/health_pkup	sounds/general/hpickup.ogg
misc/spawn		sounds/CORK.ogg
misc/teleport		sounds/general/teleport.ogg
misc/chat		sounds/menu/chatsnd.ogg
misc/chat2		sounds/menu/chatsnd.ogg
Chat			sounds/menu/chatsnd.ogg	// hexen what the fuck
misc/sundowner		sounds/SUNDOWNER.ogg
misc/emone		sounds/EMONE.ogg
misc/trombone		sounds/SADTROMBONE.ogg
misc/lamborghini	sounds/GNAWLIDGE.ogg
misc/nocheat		sounds/DSNOPE.ogg
misc/drumroll		sounds/DRUMROLL.ogg
misc/tada		sounds/TADA.ogg
misc/heart		sounds/KOKORO.ogg
misc/achievement	sounds/CTF6.ogg
misc/wow		sounds/WOW.ogg
misc/achievement2	sounds/YAY.ogg
misc/orbexplode		sounds/ORBEXPLODE.ogg
misc/omgfart		sounds/omgfart.ogg
misc/voice		sounds/dlgvoice.ogg
misc/sewercount		sounds/sewercount.ogg
misc/frag		sounds/GFRAG.ogg
misc/gibber1		sounds/general/Gib1.ogg
misc/gibber2		sounds/general/Gib2.ogg
misc/gibber3		sounds/general/Gib3.ogg
misc/gibber4		sounds/general/Gib4.ogg
misc/gibber5		sounds/general/Gib5.ogg
$random misc/gibber { misc/gibber1 misc/gibber2 misc/gibber3 misc/gibber4 misc/gibber5 }
misc/gibhit1		sounds/general/gibP1.ogg
misc/gibhit2		sounds/general/gibP3.ogg
misc/gibhit3		sounds/general/gibP4.ogg
misc/gibhit4		sounds/general/gibP5.ogg
misc/gibhit5		sounds/general/gibP6.ogg
$random misc/gibhit { misc/gibhit1 misc/gibhit2 misc/gibhit3 misc/gibhit4 misc/gibhit5 }
misc/blooddrop		sounds/general/bloddrop.ogg
misc/bodythump		sounds/general/thump.ogg
misc/flame1		sounds/misc/onfire1.ogg
misc/flame2		sounds/misc/onfire2.ogg
misc/flame3		sounds/misc/onfire3.ogg
misc/flame4		sounds/misc/onfire4.ogg
$random misc/flame { misc/flame1 misc/flame2 smisc/flame3 misc/flame4 }
$limit misc/flame 32

misc/underwater	sounds/general/uWater1a.ogg
misc/underslime	sounds/general/uGoop1.ogg
misc/underlava	sounds/general/uLava1.ogg
misc/waterenter	sounds/general/DIVE.ogg
misc/slimeenter	sounds/general/GoopJ1.ogg
misc/lavaenter	sounds/general/LavaJ1.ogg
misc/waterexit	sounds/general/surfaceb.ogg
misc/slimeexit	sounds/general/GoopE1.ogg
misc/lavaexit	sounds/general/LavaE1.ogg

misc/ricochet1	sounds/general/ric1.ogg
misc/ricochet2	sounds/general/ric2.ogg
misc/ricochet3	sounds/general/ric3.ogg
$random misc/ricochet { misc/ricochet1 misc/ricochet2 misc/ricochet3 }

misc/parry_ds1	sounds/general/parry_ds1.ogg
misc/parry_ds2	sounds/general/parry_ds2.ogg
misc/parry_ds3	sounds/general/parry_ds3.ogg
$random misc/soulsparry { misc/parry_ds1 misc/parry_ds2 misc/parry_ds3 }

misc/clonk1	sounds/clonk/clonk1.ogg
misc/clonk2	sounds/clonk/clonk2.ogg
misc/clonk3	sounds/clonk/clonk3.ogg
misc/clonk4	sounds/clonk/clonk4.ogg
misc/clonk5	sounds/clonk/clonk5.ogg
misc/clonk6	sounds/clonk/clonk6.ogg
misc/clonk7	sounds/clonk/clonk7.ogg
misc/clonk8	sounds/clonk/clonk8.ogg
misc/clonk9	sounds/clonk/clonk9.ogg
misc/clonk10	sounds/clonk/clonk10.ogg
misc/clonk11	sounds/clonk/clonk11.ogg
$random misc/clonk { misc/clonk1 misc/clonk2 misc/clonk3 misc/clonk4 misc/clonk5 misc/clonk6 misc/clonk7 misc/clonk8 misc/clonk9 misc/clonk10 misc/clonk11 }

armor/blastsuit	sounds/items/blastsuit.ogg
armor/wararmor	sounds/items/wararmor.ogg
armor/hit1	sounds/items/hullhit.ogg
armor/hit2	sounds/items/hullhit2.ogg
armor/hit3	sounds/items/hullhit3.ogg
armor/hit4	sounds/items/hullhit4.ogg
armor/hit5	sounds/items/hullhit5.ogg
$random armor/hit { armor/hit1 armor/hit2 armor/hit3 armor/hit4 armor/hit5 }

powerup/refresheruse	sounds/items/refreshuse.ogg
powerup/refresher	sounds/items/refresh.ogg
powerup/sandwich	sounds/CORK.ogg
powerup/ghost		sounds/items/CloakOn.ogg
powerup/ghostact	sounds/items/CloakLoop3.ogg
powerup/ghostend	sounds/items/CloakOff.ogg
powerup/gravity		sounds/items/gravityon.ogg
powerup/gravityact	sounds/items/gravityact.ogg
powerup/gravityend	sounds/items/gravityoff.ogg
powerup/invinciball	sounds/items/invincion.ogg
powerup/invinciballact	sounds/items/invinciact.ogg
powerup/invinciballhit	sounds/items/invincihit.ogg
powerup/invinciballend	sounds/items/invincioff.ogg
powerup/ragekit		sounds/items/ragekiton.ogg
powerup/ragekitact	sounds/items/ragekitact.ogg
powerup/ragekithit	sounds/items/ragekithit.ogg
powerup/ragekitend	sounds/items/ragekitoff.ogg
powerup/omnisight	sounds/items/omnisight.ogg
powerup/embiggener	sounds/items/embiggen.ogg
powerup/barrier		sounds/items/barrieron.ogg
powerup/barrieract	sounds/items/barrieract.ogg
powerup/barrierend	sounds/items/barrieroff.ogg
powerup/mykradvo	sounds/items/AnomExplode.ogg
$limit powerup/mykradvo 16
powerup/mykradvoamb	sounds/items/AnomHeartBeat.ogg
powerup/devastation	sounds/items/devaon.ogg
powerup/devastationamb	sounds/items/devaamb.ogg
powerup/devastationact	sounds/items/devaact.ogg
powerup/devastationhit	sounds/items/devahit.ogg
powerup/devastationend	sounds/items/devaoff.ogg
powerup/divineuse	sounds/items/divion.ogg
powerup/divineamb	sounds/items/diviamb.ogg
powerup/divineact	sounds/items/diviact.ogg
powerup/divineend	sounds/items/diviend.ogg

mykradvo/arc1		sounds/items/mykrarc1.ogg
mykradvo/arc2		sounds/items/mykrarc2.ogg
mykradvo/arc3		sounds/items/mykrarc3.ogg
mykradvo/arc4		sounds/items/mykrarc4.ogg
mykradvo/arc5		sounds/items/mykrarc5.ogg
mykradvo/arc6		sounds/items/mykrarc6.ogg
mykradvo/arc7		sounds/items/mykrarc7.ogg
mykradvo/arc8		sounds/items/mykrarc8.ogg
mykradvo/arc9		sounds/items/mykrarc9.ogg
mykradvo/smallarc1	sounds/items/mykrarcs1.ogg
mykradvo/smallarc2	sounds/items/mykrarcs2.ogg
mykradvo/smallarc3	sounds/items/mykrarcs3.ogg
mykradvo/smallarc4	sounds/items/mykrarcs4.ogg
mykradvo/smallarc5	sounds/items/mykrarcs5.ogg
mykradvo/smallarc6	sounds/items/mykrarcs6.ogg
mykradvo/smallarc7	sounds/items/mykrarcs7.ogg
mykradvo/smallarc8	sounds/items/mykrarcs8.ogg
mykradvo/smallarc9	sounds/items/mykrarcs9.ogg
$random mykradvo/arc { mykradvo/arc1 mykradvo/arc2 mykradvo/arc3 mykradvo/arc4 mykradvo/arc5 mykradvo/arc6 mykradvo/arc7 mykradvo/arc8 mykradvo/arc9 }
$random mykradvo/smallarc { mykradvo/smallarc1 mykradvo/smallarc2 mykradvo/smallarc3 mykradvo/smallarc4 mykradvo/smallarc5 mykradvo/smallarc6 mykradvo/smallarc7 mykradvo/smallarc8 mykradvo/smallarc9 }
$limit mykradvo/arc 32
$limit mykradvo/smallarc 16

lamp/on		sounds/items/lampon.ogg
lamp/off	sounds/items/lampoff.ogg
lamp/appear	sounds/items/lampappear.ogg
lamp/disappear	sounds/items/lampdisappear.ogg
moth/scrape1	sounds/items/mothatk1.ogg
moth/scrape2	sounds/items/mothatk2.ogg
moth/scrape3	sounds/items/mothatk3.ogg
moth/scrape4	sounds/items/mothatk4.ogg
$random moth/scrape { moth/scrape1 moth/scrape2 moth/scrape3 moth/scrape4 }
$limit moth/scrape 32
moth/die1	sounds/items/mothdie1.ogg
moth/die2	sounds/items/mothdie2.ogg
$random moth/die { moth/die1 moth/die2 }
moth/fly	sounds/items/mothfly.ogg
$limit moth/fly 32
// white lady (not actually mashiro)
mashiro/appear	sounds/mashiro/moth_appear.ogg
mashiro/giggle1	sounds/mashiro/moth_giggle1.ogg
mashiro/giggle2	sounds/mashiro/moth_giggle2.ogg
mashiro/giggle3	sounds/mashiro/moth_giggle3.ogg
mashiro/giggle4	sounds/mashiro/moth_giggle4.ogg
mashiro/giggle5	sounds/mashiro/moth_giggle5.ogg
mashiro/giggle6	sounds/mashiro/moth_giggle6.ogg
$random mashiro/giggle { mashiro/giggle1 mashiro/giggle2 mashiro/giggle3 mashiro/giggle4 mashiro/giggle5 mashiro/giggle6 }
mashiro/see1	sounds/mashiro/moth_anger1.ogg
mashiro/see2	sounds/mashiro/moth_anger2.ogg
$random mashiro/see { mashiro/see1 mashiro/see2 }
mashiro/attack1	sounds/mashiro/moth_attack1.ogg
mashiro/attack2	sounds/mashiro/moth_attack2.ogg
$random mashiro/attack { mashiro/attack1 mashiro/attack2 }
mashiro/hit1	sounds/mashiro/moth_hit1.ogg
mashiro/hit2	sounds/mashiro/moth_hit2.ogg
$random mashiro/hit { mashiro/hit1 mashiro/hit2 }
mashiro/flesh1	sounds/mashiro/moth_hitf1.ogg
mashiro/flesh2	sounds/mashiro/moth_hitf2.ogg
mashiro/flesh3	sounds/mashiro/moth_hitf3.ogg
$random mashiro/flesh { mashiro/hitf1 mashiro/hitf2 mashiro/hitf3 }
mashiro/active1	sounds/mashiro/moth_postatk1.ogg
mashiro/active2	sounds/mashiro/moth_postatk2.ogg
mashiro/active3	sounds/mashiro/moth_postatk3.ogg
mashiro/active4	sounds/mashiro/moth_postatk4.ogg
$random mashiro/active { mashiro/active1 mashiro/active2 mashiro/active3 mashiro/active4 }
mashiro/die	sounds/mashiro/moth_defeat.ogg
fabricator/use	sounds/items/makeammo.ogg

chancebox/explode1	sounds/items/lootexpl1.ogg
chancebox/explode2	sounds/items/lootexpl2.ogg
chancebox/explode3	sounds/items/lootexpl3.ogg
$random chancebox/explode { chancebox/explode1 chancebox/explode2 chancebox/explode3 }

newkeen/hit	sounds/keenhit.ogg
newkeen/die	sounds/keendie.ogg
newkeen/fall	sounds/keenfall.ogg
newkeen/bounce	sounds/keenbounce.ogg

menu/activate	sounds/hmenu/hmenu1.ogg
menu/backup	sounds/hmenu/hmenu2.ogg
menu/prompt	sounds/hmenu/hmenu1.ogg
menu/cursor	sounds/hmenu/hmenu4.ogg
menu/change	sounds/hmenu/hmenu3.ogg
menu/invalid	sounds/hmenu/hmenu3.ogg
menu/dismiss	sounds/hmenu/hmenu2.ogg
menu/choose	sounds/hmenu/hmenu2.ogg
menu/clear	sounds/hmenu/hmenu2.ogg
menu/advance	sounds/hmenu/hmenu1.ogg

menu/demoopen	sounds/menu/openkbase.ogg
menu/demotab	sounds/menu/menutab.ogg
menu/demosel	sounds/menu/menuset.ogg
menu/demoscroll	sounds/menu/menuscroll.ogg
$volume menu/demoscroll 0.3
menu/democlose	sounds/menu/menuclose.ogg

menu/fail	sounds/menu/failuse.ogg
menu/noinvuse	sounds/menu/failinv.ogg
menu/buyinv	sounds/menu/buysnd.ogg

$alias misc/invchange menu/demosel
UseArtifact	DSEMPTY
StartupTick	DSEMPTY

world/watersplash	sounds/terrain/DSSPLASH.ogg
world/watersplash2	sounds/terrain/DSSPLSML.ogg
world/lavasizzle	sounds/terrain/DSLVSIZ.ogg
world/lavasizzle2	sounds/terrain/DSLVSIZ2.ogg
world/sludgegloop	sounds/terrain/DSPLOOSH.ogg
world/sludgegloop2	sounds/terrain/DSPLOSML.ogg
$limit world/watersplash 8
$limit world/watersplash2 8
$limit world/lavasizzle 8
$limit world/lavasizzle2 8
$limit world/sludgegloop 8
$limit world/sludgegloop2 8

// doom vacation stuff
DSSING sounds/BRUH.ogg
DSMOAN DSEMPTY
DSVXsex1 DSEMPTY
DSVXsex2 DSEMPTY
DSVXsex3 DSEMPTY
DSVXsex4 DSEMPTY
misc/boinkend sounds/BOINK1.ogg
misc/boink1 sounds/BOINK2.ogg
misc/boink2 sounds/BOINK3.ogg
$random misc/boink { misc/boink1 misc/boink2 }

// wolf3d thingies
wolf3d/dogbite		sounds/wolfstuff/wolf3d_dogbite.ogg
wolf3d/dogdie		sounds/wolfstuff/wolf3d_dogdie.ogg
wolf3d/dogsight		sounds/wolfstuff/wolf3d_dogsight.ogg
wolf3d/doorclose	sounds/wolfstuff/wolf3d_doorclose.ogg
wolf3d/dooropen		sounds/wolfstuff/wolf3d_dooropen.ogg
wolf3d/guarddie1	sounds/wolfstuff/wolf3d_guarddie1.ogg
wolf3d/guarddie2	sounds/wolfstuff/wolf3d_guarddie2.ogg
wolf3d/guarddie4	sounds/wolfstuff/wolf3d_guarddie4.ogg
wolf3d/guarddie5	sounds/wolfstuff/wolf3d_guarddie5.ogg
wolf3d/guarddie6	sounds/wolfstuff/wolf3d_guarddie6.ogg
wolf3d/guarddie7	sounds/wolfstuff/wolf3d_guarddie7.ogg
wolf3d/guarddie8	sounds/wolfstuff/wolf3d_guarddie8.ogg
$random wolf3d/guarddie { wolf3d/guarddie1 wolf3d/guarddie2 wolf3d/guarddie2 wolf3d/guarddie4 wolf3d/guarddie5 wolf3d/guarddie6 wolf3d/guarddie7 wolf3d/guarddie8 }
wolf3d/guardfire	sounds/wolfstuff/wolf3d_guardfire.ogg
wolf3d/guardsight	sounds/wolfstuff/wolf3d_guardsight.ogg
wolf3d/hansdie		sounds/wolfstuff/wolf3d_hansdie.ogg
wolf3d/hansfire		sounds/wolfstuff/wolf3d_hansfire.ogg
wolf3d/hanssight	sounds/wolfstuff/wolf3d_hanssight.ogg
wolf3d/pushwall		sounds/wolfstuff/wolf3d_pushwall.ogg
wolf3d/ssdie		sounds/wolfstuff/wolf3d_ssdie.ogg
wolf3d/ssfire		sounds/wolfstuff/wolf3d_ssfire.ogg
wolf3d/sssight		sounds/wolfstuff/wolf3d_sssight.ogg
